5 10
|--------|
|.G.|..-.|
|..-|.@..|
|.G....-P|
|--------|